00111111111111111111
10000000000000011111
11001111111110000011
11100111111110011001
11110111111110110001
11110000001110000111
11111111101111111111
11111111100011111111
11111111111000111111
11111111111110001111
11111111111111100011
11111111111111111000
11111111111111111110
