00000000000111111111
11111111110111111111
11111111110111111111
11111111110111111111
11111111110111111111
11111111110111111111
11111111110001111111
11111111110100111111
11111111110110011111
11111111110110000111
11111111111111100111
11111111110111110111
00000000000000000000
