00111000100000001011
10011010100111100001
11001101010000110000
11100001001110001010
10111001100011100011
10001100011000111001
11100101000110000101
00110011110011110001
01001100101000111001
01100110001110001100
01011001110011100011
10000100011000111000
11000011000000111100
