00000000000000011111
01101111101111011111
01100111101111000001
01110011101111010001
00000001100000010001
01110100101011011101
00010110101011000100
10010110101011010110
10110110000011000000
00110111111011111110
00110000000000000000
10111011101111011110
10000000000000000000
