00000000000111111111
11111111110111111111
11111111110111111111
11111111110111111111
11111111110111111111
11111111110111111111
11111111110000011111
11111111110101011111
11111111110101001111
11111111111111100111
11111111110101110011
11111111110101111011
00000000000000000000
