00111111111111111111
10011111111111111111
11001111000111111111
11100000010000011111
11111001111111001111
11111100011111101111
11111111000111100111
11111111100011110111
11111111100000100111
11111111110010001111
11111111111001100011
11111111111100111000
11111111111110000000
