00000000001111111111
11111111101111111111
11111111101111111111
11111111101111111111
11111111101111111111
11111111101111111111
11111111101111111111
11111111101111111111
11111111101111111111
11111111101111111111
11111111101111111111
11111111101111111111
00000000000000000000
