00000000000000000000
00000000000000000000
00000000000111110000
00000000000100010000
00000000000000010000
00000000000001110000
00000001000001000000
00000000000001000000
00000000000000000000
00000000000001000000
00000000000000000000
00000000000000000000
00000000000000000000
