00000000000000000000
00000000000000000000
00000000000000000000
00000011111111100000
00000010000000100000
00000010111010100000
00000010001010100000
00000010101000100000
00000010101110100000
00000010000000100000
00000011111111100000
00000000000000000000
00000000000000000000
