00000000000000000000
00000000000000000000
00000000000000000000
00000010111111100000
00000010000000000000
00000010000000100000
00000010000000100000
00000010000000100000
00000010000000100000
00000000000000100000
00000011111110100000
00000000000000000000
00000000000000000000
