01111111111111111110
01111111111111111110
01111111111111111110
01111111111111111110
01111111111111111110
01111111111111111110
00000000000000000000
11111111111111111110
11111111111111111110
11111111111111111110
11111111111111111110
11111111111111111110
11111111111111111110
