00000000000000000000
01111111110011111111
01110101110000111111
01111111110110001111
01100000110111100011
01111111110111111100
00000000000000000000
10001111110111111110
11100011110110110110
11111000010011111100
11111111000100000010
11111111110111111110
00000000000000000000
